111111111111111111111
100000000000100010001
101111111110101011101
101000000010101000101
101011111010101110101
101000101010001000101
101110101011111110101
100010101000100010001
101010101111101011101
101010001000101000101
111011101010101110101
100000100010001000101
101111111111111011101
101000000000100010001
101011101110101111111
101000100010100000001
101110111011111111101
101000100010000010001
101011101110101110111
100000100000100000001
111111111111111111111

